{
"A": "a",
"E": "e",
"I": "i",
"O": "o",
"U": "u",
"DA": "da",
"DE": "de",
"DI": "di",
"DO": "do",
"DU": "du",
"JA": "ja",
"JE": "je",
"JO": "jo",
"JU": "ju",
"KA": "ka",
"KE": "ke",
"KI": "ki",
"KO": "ko",
"KU": "ku",
"MA": "ma",
"ME": "me",
"MI": "mi",
"MO": "mo",
"MU": "mu",
"NA": "na",
"NE": "ne",
"NI": "ni",
"NO": "no",
"NU": "nu",
"PA": "pa",
"PE": "pe",
"PI": "pi",
"PO": "po",
"PU": "pu",
"QA": "kwa",
"QE": "kwe",
"QI": "kwi",
"QO": "kwo",
"RA": "ra",
"RE": "re",
"RI": "ri",
"RO": "ro",
"RU": "ru",
"SA": "sa",
"SE": "se",
"SI": "si",
"SO": "so",
"SU": "su",
"TA": "ta",
"TE": "te",
"TI": "ti",
"TO": "to",
"TU": "tu",
"WA": "wa",
"WE": "we",
"WI": "wi",
"WO": "wo",
"ZA": "dza",
"ZE": "dze",
"ZO": "dzo",
"A2": "a2",
"A3": "a3",
"AU": "au",
"DWE": "dwe",
"DWO": "dwo",
"NWA": "nwa",
"PU2": "pu2",
"PTE": "pte",
"RA2": "ra2",
"RA3": "ra3",
"RO2": "ro2",
"TA2": "ta2",
"TWE": "twe",
"TWO": "two"
}
