{
"A": "a",
"E": "e",
"I": "i",
"O": "o",
"U": "u",
"JA": "ja",
"JO": "jo",
"KA": "ka",
"KE": "ke",
"KI": "ki",
"KO": "ko",
"KU": "ku",
"LA": "la",
"LE": "le",
"LI": "li",
"LO": "lo",
"LU": "lu",
"MA": "ma",
"ME": "me",
"MI": "mi",
"MO": "mo",
"MU": "mu",
"NA": "na",
"NE": "ne",
"NI": "ni",
"NO": "no",
"NU": "nu",
"PA": "pa",
"PE": "pe",
"PI": "pi",
"PO": "po",
"PU": "pu",
"RA": "ra",
"RE": "re",
"RI": "ri",
"RO": "ro",
"RU": "ru",
"SA": "sa",
"SE": "se",
"SI": "si",
"SO": "so",
"SU": "su",
"TA": "ta",
"TE": "te",
"TI": "ti",
"TO": "to",
"TU": "tu",
"WA": "wa",
"WE": "we",
"WI": "wi",
"WO": "wo",
"XA": "ksa",
"XE": "kse",
"ZA": "za",
"ZO": "zo"
}
